-11
9
-4
5
000000000000000000000
000011111100000000000
000011111100000000000
000011011100000000000
110011011100000000010
000000000000000000000
000000000000100000000
000000000000000000000
000000000000000000000
000001000000000000010
