-26
24
-15
14
000000000000000000000000000000000000000000000000000
111111111111111111111111111111111111111111111111110
100000000000000000000000000000000000000000000000010
100000000000000000000000000000000000000000000000010
100000000000000000000000000000000000000000000000010
100000000000000000000000000000000000000000000000010
100000000000000000000000000000000000000000000000010
100000000000000000000000000000000000000000000000010
100000000000000000000000000000000000000000000000010
100000000000000000000000000000000000000000000000010
100000000000000000011111100000000000000000000000010
100000000000000000011111100000000000000000000000010
100000000000000000011011100000000000000000000000010
100000000000000110011011100000000010000000000000010
100000000000000000000000000000000000000000000000010
100000000000000000000000000100000000000000000000010
100000000000000000000000000000000000000000000000010
100000000000000000000000000000000000000000000000010
100000011111100000001000000111000010000000000000010
100000011111100000000000000101000000000000000000010
100000011111100000000000000111000000000000000000010
100000011111100000000000000000000000000000000000010
100000000000000000000000000000000000000000000000010
100000000000000000000000000000000000000000000000010
100000000000000000000000000000000000000000000000010
100000000000000000000000000000000000000000000000010
100000000000000000000000000000000000000000000000010
100000000000000000000000000000000000000000000000010
100000000000000000000000000000000000000000000000010
111111111111111111111111111111111111111111111111110
